	en	fr	es
fakedetection_title	Fake detection	DÈtection de faux	DetecciÛn falsa
fakedetection_analysem	MesoNet analysis	Analyse de MesoNet	An·lisis Mesonet
fakedetection_analyseC	CapsuleForensics analysis	Anlyse de CapsuleForensics	An·lisis CapsuleForensics
			
			
			
			
			
			
			
			
			
			
			
			
			
			
			
			
			
			
			
			
			
			
			
			
			
			
			
			
			
			
			
			
			
			
			
			
			
			
			
			
			
			
			
			
			
			
			
			
			
			
			
			
			
			
			
			
			
			
			
			
			
			
			
			
			
			
			
			
			
			
			
			
			
			
			
			
			
			
			
			
			
			
			
			
			
			
			
			
			
			
			
			
			
			
			
			
			
			
			
			
			
			
			
			
			
			
			
			
			
			
			
			
metadata_desc_1			
metadata_desc_2	Number providing the duration of the movie (unfragmented part) in timescale units	Nombre donnant la dur√©e du film (partie d√©fragment√©e) en unit√© de temps	N√∫mero que indica la duraci√≥n del video (parte no fragmentada) en unidades de tiempo.
metadata_desc_3	Number corresponding to the timescale as given in the movie header	Nombre correspondant √® l'unit√© de temps donn√©e dans l'ent√™te du film	N√∫mero correspondiente a la escala de tiempo tal y como aparece en el encabezamiento del video
metadata_desc_4	Boolean indicating if the file is already fragmented	Bool√©en indiquant si le film est d√©j√† fragment√©	Booleano que indica si el archivo ya est√° fragmentado
metadata_desc_5	Number giving the duration of the fragmented part of the file in timescale units	Number donnant la dur√©e de la partie fragment√©e du film en unit√© de temps	N√∫mero que indica la duraci√≥n de la parte fragmentada del video en unidades de tiempo
metadata_desc_6	Boolean indicating if the file can be played progressively	Bool√©en indiquant si le fichier peut √™tre lu progressivement	Booleano que indica si el archivo puede ser leido progresivamente
metadata_desc_7	Boolean indicating if the the file contains an MPEG-4 Initial Object Descriptor	Bool√©en indiquant si le fichier contient un MPEG-4 Initial Object Descriptor	Booleano que indica si el archivo contiene un descriptor de objeto MPEG-4
metadata_desc_8	Array of 4CC codes corresponding to the file brands as given in the ftyp box	Tableau de code 4CC correspondant au type de fichier comme donn√© dans la boite ftyp	Matriz de c√≥digos 4CC correspondientes a las marcas de archivo tal y como aparecen en la casilla ftyp
metadata_desc_9	Date object indicating the creation date of the file as given in the movie header	Date indiquant la date de cr√©ation du fichier comme donn√© dans l'ent√™te du film	Fecha que indica la fecha de creaci√≥n del archivo tal y como aparece en la cabecera de la pel√≠cula.
metadata_desc_10	Date object indicating the last modification date of the file as given in the movie header	Date indiquant la date de derni√®re modification du fichier comme donn√©e dans l'ent√™te du film	Fecha que indica la fecha de √∫ltima modificaci√≥n del archivo como dato en la cabecera del video
track_name_1	Identifier	Identifiant	Identificador
track_name_2	References	R√©ferences	Referencias
track_name_3	Created time	Date de cr√©ation	Fecha de creaci√≥n
track_name_4	Modified time	Date de modification	Fecha de modificaci√≥n
track_name_5	Movie duration	Dur√©e du film	Duraci√≥n del video
track_name_6	Layer	Couches	Capas
track_name_7	Alternate group	Groupes alternatifs	Grupo alternativo
track_name_8	Volume	Volume	Volumen
track_name_9	Width	Largeur	Largo
track_name_10	Height	Hauteur	Altura
track_name_11	Timescale	Unit√© de temps	Escala de tiempo
track_name_12	Duration	Dur√©e	Duraci√≥n
track_name_13	Codec	Codec	c√≥dec
track_name_14	Language	Langage	Idioma
track_name_15	Samples	Echantillon	Muestras
track_name_16	Size	Taille	Tama√±o
track_name_17	Bitrate	Taux de bit	Tasa de bits
track_desc_1	"Number; giving track identifier"	"Nombre; Identifiant de la piste"	"N√∫mero; identificador de la pista"
track_desc_2			
track_desc_3	"Date object; indicating the creation date of the file as given in the track header"	"Date; indiquant la date de cr√©ation du fichier comme donn√©e dans l'ent√™te de la piste"	"Fecha; indicando la fecha de creaci√≥n del fichero tal y como aparece en la cabecera de la pista"
track_desc_4	"Date object; indicating the last modification date of the file as given in the track header"	"Date; indiquant la date de derni√®re modification du fichier comme donn√©e dans l'ent√™te de la piste"	"Fecha; indicando la fecha de √∫ltima modificaci√≥n del fichero tal y como aparece en la cabecera de la pista"
track_desc_5			
track_desc_6	"Number; layer information as indicated in the track header"	"Nombre; information de couche indiqu√© dans l'ent√™te de piste"	"N√∫mero; informaci√≥n de capa como se indica en el encabezado de la pista"
track_desc_7	"Number; identifier of the alternate group the track belongs to"	"Nombre; identifiant du groupe alternatif auquel la piste appartient"	"N√∫mero; identificador del grupo alternativo del cual pertenece la pista"
track_desc_8			
track_desc_9	"Number; width of the track as indicated in the track header"	"Nombre; largeur de la piste comme indiqu√© dans l'ent√™te de piste"	"N√∫mero; anchura de la pista como indicado en el encabezamiento de la pista"
track_desc_10	"Number; height of the track as indicated in the track header"	"Nombre; hauteur de la piste comme indiqu√© dans l'ent√™te de piste"	"N√∫mero; altura de la pista como indicado en el encabezamiento de la pista"
track_desc_11	"Number; indicating the track timescale as given in the track header"	"Nombre; indiquant l'unit√© de temps de la piste comme donn√© dans l'ent√™te de la piste"	"N√∫mero; indicando la unidad de tiempo de la pista como indicado en el encabezamiento de la pista"
track_desc_12	"Number; providing the duration of the (unfragmented part of) track in timescale units"	"Nombre; donnant la dur√©ee de la (partie d√©fragment√©e de la) piste en unit√© de temps"	"N√∫mero; indicando la duraci√≥n de la (parte desfragmentada de la) pista en unidad de tiempo"
track_desc_13	"String; giving the MIME codecs parameter for this track (e.g. ''avc1.42c00d'' or ''mp4a.40.2'') to be used to create SourceBuffer objects with Media Source Extensions"	"Cha√Æne de charact√®re; donnant les param√®tres codecs MIME pour cette piste (ex. ''avc1.42c00d'' ou ''mp4a.40.2'') pour √™tre utilis√© pour cr√©er un objet SourceBuffer avec Media Source Extensions"	"Cadena de car√°cter; indicando los parametros codecs MIME para esta pista (ej. ''avc1.42c00d'' o ''mp4a.40.2'') para utilizarla para crear un objeto SourceBuffer con Media Source Extensions"
track_desc_14	"String; giving the 3-letter language code"	"Cha√Æne de charact√®re; donnant le code de langage √† 3 lettres"	"Cadena de car√°cter; indicando el c√≥digo de idioma con 3 letras"
track_desc_15	"Number; giving the number of track samples (ie. frames)"	"Nombre; donnant le nombre d'√©chantillons de piste (c-√†-d images)"	"N√∫mero; indicando el n√∫mero de muestras de pista (es decir im√°genes)"
track_desc_16			
track_desc_17	"Number; providing the bitrate of the track in bits per second"	"Nombre; taux de bits par second de la piste"	"N√∫mero; tasa de bits por segundo de la pista"
audio_name_1	Identifier	Identifiant	Identificador
audio_name_2	References	R√©ferences	Referencias
audio_name_3	Created time	Date de cr√©ation	Fecha de creaci√≥n
audio_name_4	Modified time	Date de modification	Fecha de modificaci√≥n
audio_name_5	Movie duration	Dur√©e du film	Duraci√≥n del video
audio_name_6	Layer	Couches	Capa
audio_name_7	Alternate group	Groupes alternatifs	Grupo alternativo
audio_name_8	Volume	Volume	Volumen
audio_name_9	Width	Largeur	Anchura
audio_name_10	Height	Hauteur	Altura
audio_name_11	Timescale	Unit√© de temps	Unidad de tiempo
audio_name_12	Duration	Dur√©e	Duraci√≥n
audio_name_13	Codec	Codec	C√≥dec
audio_name_14	Language	Langage	Idioma
audio_name_15	Samples	Echantillon	Muestras
audio_name_16	Size	Taille	Tama√±o
audio_name_17	Bitrate	Taux de bit	Tasa de bits
audio_desc_1	"Number; giving track identifier"	"Nombre; Identifiant de la piste"	"N√∫mero; identificador de pista"
audio_desc_2			
audio_desc_3	"Date object; indicating the creation date of the file as given in the track header"	"Date; indiquant la date de cr√©ation du fichier comme donn√©e dans l'ent√™te de la piste"	"Fecha; indicando la fecha de creaci√≥n del fichero como indicado en el encabezamiento de la pista"
audio_desc_4	"Date object; indicating the last modification date of the file as given in the track header"	"Date; indiquant la date de derni√®re modification du fichier comme donn√©e dans l'ent√™te de la piste"	"Fecha; indicando la fecha de la ultima modificaci√≥n del fichero como indicado en el encabezamiento de la pista"
audio_desc_5			
audio_desc_6	"Number; layer information as indicated in the track header"	"Nombre; information de couche indiqu√© dans l'ent√™te de piste"	"N√∫mero; informaci√≥n de la capa indicada en el encabezamiento de la pista"
audio_desc_7	"Number; identifier of the alternate group the track belongs to"	"Nombre; identifiant du groupe alternatif auquel la piste appartient"	"N√∫mero; identificaci√≥n del grupo alternativo del cual pertenece la pista"
audio_desc_8			
audio_desc_9	"Number; width of the track as indicated in the track header"	"Nombre; largeur de la piste comme indiqu√© dans l'ent√™te de piste"	"N√∫mero; anchura de la pista como indicado en el encabezamiento de la pista"
audio_desc_10	"Number; height of the track as indicated in the track header"	"Nombre; hauteur de la piste comme indiqu√© dans l'ent√™te de piste"	"N√∫mero; altura de la pista como indicado en el encabezamiento de la pista"
audio_desc_11	"Number; indicating the track timescale as given in the track header"	"Nombre; indiquant l'unit√© de temps de la piste comme donn√© dans l'ent√™te de la piste"	"N√∫mero; indicando la unidad de tiempo de la pista como indicado en el encabezamiento de la pista"
audio_desc_12	"Number; providing the duration of the (unfragmented part of) track in timescale units"	"Nombre; donnant la dur√©ee de la (partie d√©fragment√©e de la) piste en unit√© de temps"	"N√∫mero; indicando la duraci√≥n de la (parte desfragmentada de la) pista en unidad de tiempo"
audio_desc_13	"String; giving the MIME codecs parameter for this track (e.g. ''avc1.42c00d'' or ''mp4a.40.2'') to be used to create SourceBuffer objects with Media Source Extensions"	"Cha√Æne de charact√®re; donnant les param√®tres codecs MIME pour cette piste (ex. ''avc1.42c00d'' ou ''mp4a.40.2'') pour √™tre utilis√© pour cr√©er un objet SourceBuffer avec Media Source Extensions"	"Cadena de car√°cter; indicando los parametros codecs MIME para esta pista (ej. ''avc1.42c00d'' o ''mp4a.40.2''') para utilizarla para crear un objeto SourceBuffer con Media Source Extensions"
audio_desc_14	"String; giving the 3-letter language code"	"Cha√Æne de charact√®re; donnant le code de langage √† 3 lettres"	"Cadena de car√°cter; indicando el c√≥digo de idioma con 3 letras"
audio_desc_15	"Number; giving the number of track samples (ie. frames)"	"Nombre; donnant le nombre d'√©chantillons de piste (c-√†-d images)"	"N√∫mero; indicando el n√∫mero de muestras de pista (es decir im√°genes)"
audio_desc_16			
audio_desc_17	"Number; providing the bitrate of the track in bits per second"	"Nombre; taux de bits par second de la piste"	"N√∫mero; tasa de bits por segundo de la pista"
metadata_content_title	Metadata	M√©tadonn√©es	Metadatos
metadata_content_input	Image URL in jpg/jpeg or video URL in mp4/m4v format	Adresse de l'image au format jpg/jpeg ou video au format mp4/m4v	Enlace del imagen en formato jpg/jpeg o video en formato mp4/m4v
metadata_title	Video Metadata	M√©tadonn√©es de la video	Metadatos del video
track_title	Video Track	Piste vid√©o	Pista de video
audio_title	Audio track	Piste audio	Pista audio
